11111111111111111111111111111111111111111111111111
11455555555555555555555555555555555555555555555511
11400000000000000000000000000000000000000000000011
11400000000035555555554045555555444450544444455511
11400000000034444555555055555555433000000033455511
11400000000034444555555055555555433000000033455511
11444444444444444555555055555555433000000033455511
11555555555555555555555055555555433000000033455511
11555555555555555555555055555555433333333333455511
11555555555555555555555055555555444444444444455511
11555555555555555555555055555555555555555555555511
11555555555555555555555055555555555555555555555511
11333333333333333333334033333333333333333333333311
11333330000000000000000055553333333333333333333311
11333330333333333333334000005553333333333333333311
11244440444444444444444000005555555555555555555511
11000000444445555555555000000000005555555555555511
11440000000045555555000000000000000555555555555511
11440000000045555555044000000000000005555555555511
11000000000045555440024000000000000000000000000511
11044444444445555420224000000000000000000000000511
11024555555555555420224000000000000000000000000511
11024555555555555420224555555555555555555555555511
11024555555555555420224555555555555555555555555511
11024555555555555420224555555555555555555555555511
11024555555555555420224555555555555555555555555511
11024555555555555420224555555555555555555555555511
11024555555555555420224555555555555555555555555511
11024555555555555420224555555555555555555555555511
11054555555555554220224555555555555555555555555511
11054444444444444440444444444444444444444444444411
11000000000000000000000000000000000000000333333311
11050000000000000000000000000000000000000333333311
11044444444444444404444444444444444444444444444411
11045555555555555400000055555555555555555555555511
11045555555555555444444055555555555555555555555511
11042222222222222222224002222222222222222222222211
11044444444444444422222400000000000000000000000011
11000000000000000422222400000000000000000000000011
11000000000000000422222400000000000000000000000011
11000000000000000444424400000000000000000000000011
11400000000000000000000000000000000000000000000011
11400000000000000000000000000000000000000000000011
11400000000000000000000000000000000000000000000011
11400000000000044444444400000000000000000000000011
11400000000000042222222400000000000000000000000011
11400000000000042222222400000000000000000000000011
11400000000000042222222400000000000000000000000011
11444444444444442222222444444444444444444444444411
11111111111111111111111111111111111111111111111111

